11111111111111
1E000001000P01
100000C1110011
11110001000101
10001001000101
10000100000001
11111111111111