1111111111
1000001001
1E001C0001
1111110C11
1P00000101
1111111111