1111111111
1000000C01
10E0100111
1111110011
1P000C0101
1111111111
